#####################
#.............#.....#
######..#..####...#.#
#..H.#..#..#.F....#.#
#.####..#########.###
#....#..............#
##.###..#####..######
#..........##..#....#
#..######......#.##.#
#.......#..#####..#.#
#..#...H#..#......#.#
#..######....###.##.#
#..#....######......#
#....##.....##.###.##
#..##..........##...#
#.##..###########.#.#
#....##...........#.#
#...###..##########.#
#..#.##.####.>.###F.#
#H.#.............#..#
#####################