#####################
#...............#..F#
#######.####.####.#.#
##........#.......#.#
###.#####.#..######.#
#...#H....#..##.....#
#.#.#######..##..##.#
#.#.......#.......#.#
#.##...##########.#.#
#......#...H......#.#
#.####.############.#
#.#.................#
#.########..#########
#........#..#.......#
#.########..#..####.#
#.F#...>.#........#.#
###..#####..#..#..#.#
#...##......#..#..#.#
#.##.H####..####..#.#
#............#F...#H#
#####################